
afterwards = entonces
ALLOW = permitir
ALL_THE_X_BRANCHES = todas las x ramas
AND = y
AS_LONG_AS = mientras
BOTH_BRANCH = ambas ramas
EXECUTE = ejecutar
IN_CONCURRENCY_TO_THE_LATTER_STEP = en concurrencia al ultimo de los pasos
IN_CONCURRENCY_TO_THE_LATTER_X_STEP = en concurrencia a los ultimos x pasos
INTO_X_PARALLEL_BRANCHES = en x ramas paralelas
ONE_OF_THE_FALLOWING_BRANCHES = una de las siguientes ramas
ONE_OR_MORE_OF_THE = un o mas de los
ONCE = una vez que
CONDUCT = conduce
CONTAIN = contiene
CONTINUE = continuar
DECIDE = decide
FINALLY = por fin
FINISH = terminar
FOR = para
FOR_THE_FOLLOWING_DEVIATIONS = para las siguientes desviaciones
FOLLOWING = siguientes
IN_ADDITION = en adicion
IN_CASE = en caso
IF = si
LOOP = lazo
NO = no
OTHERWISE = de otra manera
PATHS = siguientes caminos
PROCESS = proceso
PROCESS_INSTANCE = instancia de proceso
REPEAT = repetir
SPLIT = divide
START = empezar
STEP = paso
SUBSEQUENTLY = mas tarde
THE = lo
THEIR = de ellos
THEN = entonces
THE_PROCESS_BEGIN_WHEN = el proceso empieza cuando
UNSTRCUTURED_PART = parte no estructurada
UNSTRCUTURED_PART_WHICH_CAN_BE_EXECUTED_AS_FOLLOW = parte no estructurada que puede ser ejecutada de la siguiente manera
WITH_DECISION = con la decision
WHEN = cuando
YES = si
you = usted