afterwards = em seguida
allow = permitir
ALL_THE_X_BRANCHES = todas as x ramificacoes
and = e
as_long_as = contanto
BOTH_BRANCH = ambas ramificacoes
EXECUTE = executar
IN_CONCURRENCY_TO_THE_LATTER_STEP = paralelamente ao ultimo passo
IN_CONCURRENCY_TO_THE_LATTER_X_STEP = paralelamente aos ultimos x passos
INTO_X_PARALLEL_BRANCHES = em x ramificacoes paralelas
ONE_OF_THE_FALLOWING_BRANCHES = uma das seguintes ramificacoes
ONE_OR_MORE_OF_THE = um ou mais dos
once = uma vez que
conduct = conduz
contain = contem
continue = continuar
decide = decidir
finally = finalmente
finish = terminar
for = para
for_the_following_deviations = para os seguintes desvios
FOLLOWING = seguintes
in_addition = em adicao
in_case = no caso
if = se
loop = ciclo
no = nao
otherwise = sen√£o
paths = seguintes caminhos
process = processo
process_instance = instancia de processo
repeat = repetir
split = divide
start = comecar
step = passo
subsequently = subsequentemente
the = o
their = deles
then = entao
the_process_begin_when = o processo comeca quando
UNSTRCUTURED_PART = parte desestruturada
UNSTRCUTURED_PART_WHICH_CAN_BE_EXECUTED_AS_FOLLOW = parte desestruturada que pode ser executada como se segue
WITH_DECISION = com decisao
WHEN = quando
yes = sim
you = voce